R 1280 720
C 173,216,230
F 125,125,125
WE ./textures/mossy.xpm
NO ./textures/wood.xpm
S ./textures/tonneau.xpm
SO ./textures/redbrick.xpm
EA ./textures/greystone.xpm


 11111111111111111111111
1000000000110000000000001
101100001110002000000001
10010000000000000000000011111111
 1111111101100N01110000000000001
10000000001100000111011111111111
 1110111111111011100000010001
  110111111111011101010010001
 1000000110101011100000010001
1000000000000001100000010001
10000000000000001101010010001
 1000001110101011111011110011
  11011   110101 1011 1010001
    1       1 1   1    1 111
