R 1280 720
C 173,216,60000
F 125,32,125
    t
WE ./textures/mossy.xpm
NO ./textures/wood.xpm
S ./textures/tonneau.xpm
SO ./textures/redbrick.xpm
EA ./textures/greystone.xpm

1111111111111111111111111
1000000000110000000000001
1011000001110000002000001
10010000000000000000000011111111
1111111110110N001110000000000001
10000000001100001110111111111111
11110111111111011100000010001
11110111111111011101010010001
11000000110101011100000010001
10002000000000001100000010001
10000000000000001101010010001
1100000111010101111101111000111
11110111 1110101 101111010001
11111111 1111111 111111111111

R 1280 720